

         NO ./textures/NIgg.png
    SO ./textures/EA.png
WE ./textures/WE.png
EA ./textures/NO.png

         F 0,0,0
           C 0,0,0



11111111111111
10000000000001
10000001000001
10000000000001
1001000N000101
10000000000001
10000000000001
10000001000001
10000000000001
11111111111111