

         NO ./path_to_the_north_texture
    SO ./path_to_the_south_texture
WE ./path_to_the_west_texture
EA ./path_to_the_east_texture

         F 0,0,10
           C 20,05,25




10101111111111111111111111111111111111
1101         10000000001100000000000011
1010  0  1    1011000001110000000000001
1101     1 11000000000000000000000001
111111111011000001110000000000001111111111111111111111
100000000011000000000000000000000000000000000000000001
111101111111110111000000100000000000000000000000111111
111101111111110111010100100000000000000000000000000111
110000001101010111001000100000000000000000000000000001
100000000000000011000000100000000000000000000000000001
100000000000000011010100001000000000000S00000000000001
11000001110101011111011110000000000000000000000000000111
11110111 1110101 1011110100000000000000000000000000001
11111111 1111111 1111111111111111111111111111111111111

