

         NO ./path_to_the_north_texture
    SO ./path_to_the_south_texture
WE ./path_to_the_west_texture
EA ./path_to_the_east_texture

         F 255,0,10
           C 20,255,25




1010         1111111111111111111111111
1101         1000000000110000000000001
1010  0      1011000001110000000000001
1101         1000000000000000000000001
111111111011000001110000000000001111
1000000000110000N1110111111111111
11110111111111011100000010001
11110111111111011101010010001
11000000110101011100000010001
10000000000000001100000010001
10000000000000001101010000101
1100000111010101111101111000111
11110111 1110101 101111010001
11111111 1111111 111111111111

