

        NO ./textures/studio1.png
    SO ./textures/water.png
WE ./textures/studio5.png
EA ./textures/studio4.png


   C 0,0,100
        F 80,50,25

        1111111111111111111111111
        1000000000110000000000001
        1011000001110000000000001
        1001000000000000000000001
111111111011011001110000000000001
1000000000111  10001110111111111111
11110111111111111100000010001
11110111111111011101010010001
1100000011010111110000S010001
10011111110000011000001100011
10000000000000001101010010001
11000001110101011111011100111
1111011111101011011110100011
1111111111111111111111111111

