

         NO ./textures/studio2.png
    SO ./textures/studio5.png
WE ./textures/studio3.png
EA ./textures/studio1.png

         C 0,0,100
           F 80,50,25




10101111111111111111111111111111111111
1101         10000000001100000000000011 11
1010  0  1    1011000001110000000000001 101    
1101     1 11000000000000000000000001   111
111111111011000001110000000000001111111111111111111111
100000000011000000000000000000000000000000000000000001
111101111111110111000000100000000000000000000000111111
111101111111110111010100100000001000000000000000000001
110000001101010111001000100000000000000000000000000001
100000000000000011000000100000000000000N00100000000001
100000000000000011010100001000000000000000100000000001
11000001110101011111011110000000000000000010000000000011
11110111 1110101 1011110100000000000000001000000000001
11111111 1111111 1111111111111111111111110011111111111
